{
  "width": 37,
  "height": 27,
  "tileSize": 32,
  "rows": [
    "#####################################",
    "#BB...............................BB#",
    "#BBB.............................BBB#",
    "#...................................#",
    "#...T...........................T...#",
    "#....T.........................T....#",
    "#...................................#",
    "#...................................#",
    "#...................................#",
    "#.......S....S.........S....S.......#",
    "#...............BBBBB...............#",
    "#.............B.B.B.B.B.............#",
    "#..........T.............T..........#",
    "#...............~~~~~...............#",
    "#..........T.............T..........#",
    "#.............B.B.B.B.B.............#",
    "#...............BBBBB...............#",
    "#.......S....S.........S....S.......#",
    "#...................................#",
    "#...................................#",
    "#...................................#",
    "#....T.........................T....#",
    "#...T...........................T...#",
    "#...................................#",
    "#...................................#",
    "#BBB.............................BBB#",
    "#####################################"
  ],
  "spawnRegions": {
    "TOP_LEFT": { "x": 1, "y": 1, "width": 8, "height": 8 },
    "TOP_RIGHT": { "x": 28, "y": 1, "width": 8, "height": 8 },
    "BOTTOM_LEFT": { "x": 1, "y": 18, "width": 8, "height": 8 },
    "BOTTOM_RIGHT": { "x": 28, "y": 18, "width": 8, "height": 8 }
  }
}
